{
  "map": [
    "###############",
    "#M.#..........#",
    "#P.#...FFFFF.F#",
    "#..#...F#....F#",
    "#..#...F#.FF.F#",
    "#..#...F#.F..F#",
    "#..#...FE.F.FF#",
    "#..#...FFF..FF#",
    "#......#.....C#",
    "###############"
  ]
}