{
  "map": [
    "###############",
    "#F.....#..#C..#",
    "##P....#..###.#",
    "#####..#..#...#",
    "#...#..####.#.#",
    "#####.........#",
    "#.#...###.....#",
    "#.#.....#.#####",
    "#...#...#...BE#",
    "###############"
  ]
}