{
  "map": [
    "###############",
    "#.P...#....C..#",
    "#.###.#.#####.#",
    "#.....#.....F.#",
    "#####.#####...E#",
    "#............R#",
    "###############"
  ]
}